---------------------------------------------------------------------------------------B-B----------------------------------------X-----------------------------------X---------------------------------
---------------------------------------------------------------o------------------------?-o-------------------------------------o-----------o-----------------------------------------o-----------------
------------------------------------M-----------------X------------------o---o----------M-------------------X---------------------------------------------------------------------------------B---------
-B---X-------------------M-------------------------------B-----------M-------------------o-----------------------BB-----------------------------o---------o----o--------------------M-------------------
-------------------------?------B---------------M--------B--?-----------------------B----X----------------X-o?------------X----?-----------------o----B-------------------B-----?----X------------------
----------B---o-M--o------------------------------------------------o--X---------BX---------------------------------------------------------------------------------------------------------------------
---------------------------------M---------M-----------B-------------X----------B---------?------------------X----------M----------------------------------------------------X----o-B--?------B---------
----------------------M----???---------------------------B-----------------------------B----------??????--?----------------BBBBBB----X-------------------------------------------?---------------------v
--------------------------------------------BM---------o--------????----------------------M------------o-------------------o---o------------------------------X---------------XXX----------------------f
-------------------------------------BBBBBBB------------------------?????---------------------------------------------------------------------------------------BBBBBBB--------------------------------f
--X-----------------------------------------------------------------------------------------------------------???-----------------------------------------------------XXXXX---------X------------------f
----------------------------------------------------?????-----------------------------------------------------BBBBB------------------------------------------------------------------------------------f
-----------------------XXX-------------------------------------------?????------------------------------------------------------------BB---------XBBBBBBB-B-------X------------------------------------f
--------???------???????-------------------T-------TT--------T--------------T-------TXXXXXX----T--T---TT------------T-------XXXXXX--------------------------------XX-------------T------T-----T--------f
m------E----------------------------------E|-------||ETT-----|---T-----?????|----E-E|--T-------|--|--E||-T-------E--|---EE---E------X------E--------X---T-T-E-XXXXXXXT----T----X-|------|-----|------E-X
XXXXXXXXXXXXXXXXXXX-XXXXXXXXXXXXXXXXXXXXXXX|XXXXXXX||X||XXXXX|X--|XXXXXX-XXX|XXXXXXX|XX|XXXXXXX|XX|XXX||-|XXXX----XX|XX-XXXXXXX-XXXXXXXXXXXXXXX-XXXXX-XX|-|XXXXXXXXXX|XXXX|XXXXXX|X--XXX|XXXXX|XXXXXXXXX
