-----------------------------------------------------------------------------------------B--------------------------------------------o--------------------------------------------B--------------------
-----------------------------------------------B------------------------------o---B-------o----------------------?-------------------------B--------------X---------------------M-----------------------
------------------------------------o------------------------------------o-------------------------------------------------------o-------------------------------------------o-------M------------------
----------------------?------------------------------------------------------------------o------------?-----------B--------------------M--------?---------X----o-------o------------------X-------------
----------------------------------------------------------------------------------------------------------X---------------o----?--------------------o-B------------------------------------------o------
-----------M----------------------------------------------------------------------X-------X------------------?-------X----X-----------------------------------------------------------------------------
-------------------------------------------------------------B----?-------B----B-------------------------M----------------------------------------------------------B-----------------------------------
----------------------------------BBBBBB---X-----------B-B-MXXXX----B-----------------------------?????o--------------------------XXXXXXXX-------------------------------------------------------M-----v
------?????------------------------------X----X---------------B-----M-----------------o----------M-----o------o---BBBBBBB------------------------------------M----o-------------------------o----------f
------------------------------------------------------------------------------------------------------------------------XX--------------------------------------BBBBBBB--------------------------------f
-----XXXXXXX-------------------------------------------------------------------------------------------------------------------------------------------------------------------------------------------f
--------------------------------------------------------------------XXXXXX--------------------------------------------------------------------?????---------------------------------------BB-----------f
---BBBBBBBB-----------------------------------------------------------------------------------------XXXXXXXX----------------X---------BX--------------------------------BBB----------------------XXXXXXf
---T-------------------T-------------------------T-------?T?-T---------T--------X---------------XTT------------T-T--X-------XX---T-----XX--T-T------------------------------------------T--------------f
m--|-E--------EE-------|------------------T------|---E----|--|-----T---|-------XX--E----------T-X||--------E--E|-|T---------XXX-T|---E-XXX-|-|T-T---TT---E-----------T------E-----------|--------------X
XXX|XX--XXXXXXXXXXXXXXX|XXXXXXXXXXXXXXXXXX|XXXXXX|XXXXXXXX|XX|XXXX-|XXX|XXXXXXXXXXXXXXXXXXXXXX|XX||XXXXXXXXXXX-|X||XXXXXXXX-XXXX||XXXXXXXXX|X||X|-XX||XXXXXXXXXXXXXXX|X-XXXXXXXX--XX--XX|XXXXX-XXXXXXXXX
