--------------------------------o---o--------------------o-----------------------------B----------------------------------------------------------------------------------------------------------------
--------------------------------------------------------------------------------------------------------------------------------o---------------------------B-------------------------------------------
------------------------------X-------------------------------------------M----------------------?-o--------------------------------------------------------o-------------------------------------------
----------------X-------------------------------------------------------------------B-----------------?-----------------------------------------------?-------------------------------?-------B-o-------
-----------------------------X----------X-------------------?----------o----------------------------o---------------------?------------------------------------------M---B------------------------------
---------------------------------o------X-----------------------?-------B-------------------------------------------------------------------------------------------------------------------------------
-------------------------------M------------------------------------------------o-------------------------------------------------------------------------------------------BM------------------------?-
----------------------???--------------X---------------B--------------------------------o----------------------------o--------------------B-----------------------------o------X----o--B---------------v
----------------M--XoXXXX---?-------??--------X--------BBBBBBBX-????----B-----------------------------------------------------BBBB--------------------------------------o------------------------------f
-------------------------------------------------------------------------------------------------------------------------------------------------------------------------------------------------------f
------------------------------------------------------------------------------------------BB------------------------------------------------------------------------------------?----------------------f
-------------------------------------------------------------------------------------------------------------------------------------------------------------------------------------------------------f
---------------------------------------------------------------------?????--------------------------BBBBBBBB-----------------X------XXXXXXXX---------------XXX-----------------------------------------f
--------BBBBBBBB------------X-----------T-----------TT--------------------------X---T---------T---------------------------T--XT-------------T-------------------------------------T--------------------f
m------------------E-----E--XX---?------|EE-E----E--||-TT---ET--E--------------XXE--|-----E---|-E--E----------------------|E-X|X-----E?T----|-BEBBBBB-------------------T---------|------------BBBTEBBBX
XXXXXXXXXXXXXXX--X--XX--XXXXXXXXXXXXXXXX|XXXXXXXX---||X||XXXX|X--X--XXXXXXXXXXXXXXXX|XXXXXXXXX|XXXXXXXXXXXXXXXXXXXXXXXXXXX|XXX|XXXXXXXX|XXXX|XXXXXXXXXXXXXXXXXXXXX--XXXX|XXXXXXXXX|X-XXXXXXXXXXXXX|XXX-X
