-----------------------------------------------------------------------------------------B-----------------------------------------------------------------------------------------B------------------X-
----------------------------------------X-----------------------------------------B-----?-o------------------------------------------------B----------------------------o------MM-----------------------
------------------------------------M-----------------X--------------------?------------M-----------------------------------------------------------------B---------------------------------------------
-------------------------M----------------------------------------------------------------------------------------B--------------------------------------------o----------------------------------------
-------------------------------------------------B--------------------?-------------B-------------------------------------o---------------------------B------------------BB----------------------o------
-----------M--------------------?-X-----------------------------------------------X-----------?----------------------X-----------------------------------------------------------?----------------------
---------------------------------M---------M-------------------------X----------------------------------------------------------------------------------------------B-----------------------------------
---------------------------???----BBBBBB-------o---------B---------------------------------M------??????-----------------------------X---------------B------------------?????o-------------------------v
------?????------------------------------X--B---------------????--------------------------M------M-----------------------------------------------------------------------------------------------------f
------------------------------------------------------------BBBBBB----------------------------------------------------------------------------------------------BBBBBBB--------------------------------f
-----XXXXXXX--------------------------------------------------------------------------------------------------???---------------------------------------------------------------------------XXXX-------f
---------------------------------------BBB------------??---------?????-----------------------------------------------------------?????-----------------------------------------------------------------f
---BBBBBBBB------------XXX-------------------------------------------------------------------------------------------X----------------BB---------XXX--------------------BBB----------------------XXXXXXf
---T-------------------T---------------T---T--T--T-T--------------------------------T-------XXXX-------X-------T--T--XX----------T--T----------------------------------------------T----T--------------f
m--|-E-E---------------|---------?-----|--T|--|--|-|--TE------E---------X-------EE-E|----TE-------------------E|--|--XXX--------T|--|------E--------T-----E------------------------|-T--|------EBBBBBBBX
XXX|XX--XXXXXXXXXXXXXXX|XXXXXXXXXXXXXXX|XX||--|XX|-|XX|XXXXXXXXXXXXXXXXXXXXXXXXXXXXX|XXXX|XXX--XXXXXXXXX-XX--XX|XX|XXXXXXXXXXXXX||X-|-XXXXXXX--XXXXX|-XXXXXXXX--XXXXXXX-XXXXXXXXXXX|-|XX|XXXXXXXXXXXXXXX
