--------------------------------o-----------------------------------------------------------------------------------------------------------------------------------------------------------------------
-----------------------------------------------B--------------------------------------------------------------------------------------------------------------------------------------------------------
-----------------------------------------------------------------------------------------------------------------------------------o-------------------------o---------X---------------?----------------
--o--------------------------X------------------------------------------o-----------------------------------------M----------------------------------------B--------------------------------------------
---B------------X-----------o-------------------------------------------------------------------------M------------------------------------o------------------------------------------------------------
--------------------------------------------------------------o-----------------------------------------------------------------o-----------------------------------------------------------------------
---------X--------?------------M-----------------------------------------B------M----------------------------------------------?-------------------------------------------------------------M----------
---------------------------------------------X--------------------------------------------------------------------------------------------------o------------------------------------------------------v
--------------------------------------------------------------------M-----------------------------------X--------------------------------------?-------------------------------------------------------f
--------------------------------------------------------------------------------------------------------------------------------------------------------------------------------------BBBBBBBB---------f
--???-----------------------------------------------------------------------------------------------------X--------------------------------------------------------------------------------------------f
-------------------------------BBBBBB------------------------------------------------------------------X-----------------------------------------------------------------------------------------------f
----------------------------------??????--------------------------------------------------------------XX-----------------------------------------------------------------------------------------------f
----------------------------------BT-------------------------------------------------------------T---XXX---T---------------------------------------------------T-------------------------T-----T-------f
m--TBBBB---T--------E--------------|-E-------------------E---------------------------------------|--XXXXE--|----------T-----T-----------------E------------????|--------------------E-E--|--T--|-------X
XXX|XXXXX--|XX-XXXXX-XXXXX--XX--XXX|XXXXXXXXXXXXXXXXXXXXXXXXXXXXXXXXXXXXXXXX--XXXXXXXXXXXXXXXXXX-|XXXXXXXXX|XXXXXXXXXX|XXXXX|XXXXXXXXXXXXXXXXXXXXXXXXXXXXXXXXXX|XX--XXXXXXXXXXXXXXXXXXXXX|XX|XX|XX--XX-X
