----o--M-B----?o-----?--|------------|-M----B--X-----------o-----EB-E----T-|-E-o--TT-T-XT---X-------------|---TBM------E--X--------?-----EX-----o---------XB?-M-----T---------EET-E--------|------XX?-|-
----T-----T----X--?---o----B-------|----------M----X----|-----------M------X--?oX-----------|----?--o----E---E----T---o--o-T--T|----------|?----X?|?----E--T----T----T?------M-T-X--X------------E---E--
------MXB--?---o-o----TM--o-----|----M?X-------|B-----------?------||---------?--X------BT?--X-X---B--------------|-o------T------X-----------B------?-----|-E--XBTTX--M---X--------T----E----B--M-M-|--
------------X??-----E--------B--------TM-------o-----M---E--B-B-X-|--T----B-T-E-o--------BT-------X-------T-----B-|---X-TM---------X--o-B---E---M----?---MB----------X----?--------------ooM-----X-XM---
-M-o---?B|--B--------T|--M|-----------?-----------|-------T--------o--------E---T-M----------B--TM-MT-?oMT------B-B-----M-----T-M-T---o--?-T-X-------|---M-|-X-BE-?M-M-----B--T-o----B---T?--X----E---M-
-M--M--BB---------|B-M-----o---ToM-X|-------?-T---E--T-X--E---?-T----T-M---?-|-o-?T---X-o-?X--B---X-?---------Bo---T--M--M--?------|---M----|---|-------?X-o--X--X--BX-M---E----?----------X-X-o----T---
-----To---B---?---E------X--MM---BE-o?E---------------?--|----------------X--|--------o---E--|--o-?-|-----T-T------B-------M-------?----------T-oX-|---T---------|-B--------------?--BB--B-o-------M-|X-
------M---o----T-oo---o-X-------T-o-|-E--E?--M-------?B----|---T-ETM-o------------o-----B----------------o----o-----oE-o-E----B--|--------B-------E-----T-X----T-T---o------o-BE-----M---B---X|--------v
--B-T--T-----------o---?-|------?-------?-E-T--E--EE--oT---oT?-|-B-T-M----T--T--|-----E?--------B-M-E------B-o-M---E--TM?EMX?-|-X--------X-|--M?-------T-----------TM-X-------?X----M--------|-M-----M-f
-B--------MM-TB---o-M--T--|?-------o--B-X-----?-|----------------M-B----M---?-TB-B-----?--M-B--M---------?---B---|--------?-M--X--------M-oT--T-?B-oo--M--|-B----X------E--?---B--|---T-M--TT------T---f
---X--B---T---M-----------E--------------EX--T-T-XB-----E-T|---X-------?-------|?M---M-oB-----E---E----X--E-----o?-?--?-------EMT--X-----X---------B--|----M---E-o--X|--X----o-?-oo-----T----B--?T-|o--f
-E---------|------EME-T-o-----T--T--XB--E--X--o-E-----X-T|-X----EM---E---M-B---X-----M---B-----------?--------T----------?MXM-oT----B----oMBoB-------------T||-|B----TMTX-------E---B------?------o-|--f
------X--X---|-X--E---|----T-BM-----M--T--|----------EB--|--X----MM------------B-T-------------M----T--B-o-----------?--M--X---E---E----?----o-T------------T--o??-MX-E?---T-T---BB----------oBM------Tf
------------o------o------|-------|X------?----M--E--E?--B-ME--o-M------MX--E------o-|----B-----T-----M----X----oo-----E----XBo----------E-Xo--E-X---M-----------o---M-T-----X-ME-----?--o-ET----o|----f
mo--E---T--B---------oT----o|--o-|-E-B---MM-T--o||---?------?-MT-----------B---B--X-------|-----M------B?---M------EM---|X|-T-M--B-oM-T--Eo-------X-----T---E-----oM-E-|--E------?--B?-o--------------BX
XXXEXXMXoXoXXXXXXXXXXXXXXBXXXXXXMXXXo?XBXXXXXXXX?XXXXXXMXXTXXXMXXXTXXXXXX?XXXMXXEXXXXXXXMXTXEXXoX|XMEXXX?TX?XXXTXXXX?XXXX|XXXXXX-XXXXXXXX-XXXX?EoXMXXBoXXXXX|XXXXE-XXTXXXXXXXXXXXTXXXXEE?XXEXXBXXXXXoXXX
