----------------------o------------------------------------------------------------------B-----------------------------------------------------------------------------------------B--------------------
----------o----------------------------o------o-----------------------------------------?-o----------------------?--------------------------------------------------------------M-B---------------------
------------------------?-----------------------------X------------------o--------------MX------------------X----------------------M--------------------------------------------------------------------
---------------------------------------------------------B----------------B--------------o------------------------B--------------------------------------------o--------------------------X-------------
------------------------------------------------------------------------------------B-----------------------o------------------?--------------------o-B-------------------B-----------------------------
---B------------------------------X-----------------------------------------------X----------------------------------------------------------------------------------------?----------------------------
-------------------------------------------M-------------------------X---------------------------------------X------------------------------------------------------B-----------------------------------
--------------????---?-----???---------------------------B------B---------------------------------?????o-----------------------------X----------------------------------------------------------XXXX---v
-o------------------------------------------BM---------o-------------------------?????----M------B-----o-------------------o------------------------------------------------o--------------------------f
--------------------------------------------------------------------?????-------------------??????--------------------------------------------------------------BBBBBBB--------------------------------f
--------------------------------------------------------------------------------------------------------------???---------------------------------------------------------------?????-------B----------f
---------------------------------------------------------------------------------------------------------------------------------?????--------?????----------------------------------------------------f
-------------------------------B------------------------------------------------------------------------XXXX--------------------------BX---------XBBBBBBB------X---------------------------------XXXXXXf
-T----------------------------------T------T-------T---------T------------------------------------T---T--------------------------------XX---------------------XX-------------------T----T--------------f
m|------------E---E------------T----|EE---T|E------|--T------|---T--------------T--E-------------X|---|------------------E---EE------EEXXX-E-----------E-----XXX-----T------------T|----|E-----E-------X
X|--XXXXXXXXXXXXXXXXXXXXXXXXXXX|XXXX|XXXXX||XXXXXXX|-X|XXX--X|X--|XXXXXXXXXXXXXX|XXXXXXXXXXXXXXXXX|XXX|X-XXXXXXXXXXXXXXXXXXXXXXXXXXXXXXXXXXXXXXX--XXXXXX--XXXXXXXXXXX|X-XXX--XXXXX||-XXX|XXXXXXXXXXXXXXX
