-------------------------B------o--------------------------------------------------------B-----------------------------------------------------------------------------------------B--------------------
------------------------oM--------------o------B----------------------------?-----------?-o----------------------?--------------------------------------------------------------M-----------------------
----------------o-------------------M------o--B-------X------------------o--------------M------------o---------------o--------M----M-------------------------o------------------------------------------
--o--------------------------X-----------------------------------------------------------o------------------------B---B-------------------B----------------B---o-----?--------------------X-------------
---B------------X----------oo---B---------------------------------------------M-----B-----------------------------------?-------------M----o--M--o----B-------------------B-----------------------------
--------------o---o----o----------X----------------------------------------------BX---------------------------------------------------------------------------------------------------------------------
---------X--------?------------M-M---------M-------------------------X------------------------------------o---------------------------------------------------------B-----------------------------------
----------------------------------------B----------------B----------------M---B------------M------??????-----------------------------X--------------------------------------o--------------------------v
---------------------------------?----------BM----------------------M-------------------o-M------------o-----------------------o----------------M---------------------------o--------------------------f
--------------------------------------------------------------B------------------------------------------------------------------------???----------------------BBBBBBB--------------------------------f
--???-----------------------------------------------------------------------------------------------????????--???-------------------------------------------B------------------------------------------f
---------------------------------------------------------------------------------------------------------------------------------?????--------?????----------------------------------------------------f
-----------------------XXX--------??????-------------------------------------------------XXXX-----------XXXX--------------------------BX---------XXX---------------------------------------------XXXXXXf
----------------------------------BT---T---T-----T-T----T???----------------T------TT-----------------------------X--------------------XX------------------------------XT----------T----T--------------f
m--TBBBB---T---T-BBBBBBB-----------|-E-|--T|-----|-|T-TE|----E--------------|----E-||---------T----------TBBE-------E----E-------------XXX-E------------------X------TXX|----------|----|------E-------X
XXX|XXXXXX-|XX-|XXXX-XXXXXXXXXXXXXX|XXX|XX||XXX-X|-||X|-|XX--XXXXXXXXXXXXXXX|XXXXXX||XXXXXXXXX|XXXXXXXX--|XXXXXX--XXXXXXXXXXXXXXXXXXXXXXXXXXXXXXXXXXXXXXXXXXXXXXX--XX|XX|XXX--XXXXX|-XXX|XXXXXXXXXXXXXXX
