-------------------------------o----------B-------------------------------------------------------------------------------------------------------------------------------------------------------------
----------------------------------------------------------------------------------------------------------------------o----------------------------------------------------------------------M----------
--------------------------------o-------------------------------------------------o----------X---------------------------------------------------------------o-------------?----------------------------
------------B------------------------------------------------------------------------------------------------------------------o---------------------------B--------------------------------------------
-------o--------------------------------M---------------------------------------------------------------------------------------------------------------------------------------------------------------
------------------------------------------------------B---------------------------------------X------------------------------------------------------------------------------------------------X-----X--
---------------------------------B----------------------------------------------------------------------------------------------------------------------------------------------------------------------
-------------------------------------------------------------------------------------------------------------------------------------------------------------------------------------------------------v
-------?-----------X------------------------------------------------------------???????-----------------------------B----------------------------------------------------------------------------------f
-------------------------------------------------------------------------------------------------------------------------------------------------------------------------------------------------------f
--------????????------------------------XXXXXXX--------------------------------------------------------------------------------------------------------------------------------------------------------f
-----------------------------BBB--------------------------------------------------------------------------------------------BBBBBBB------------------------------------------------X-------------------f
------------------------------------------------------------------------------------X--------------------------------X------------------------------------------------------------XX-------------------f
--------------------------T------------T--------------------------------------------XX------------------------------XX------------------???????----------------T-----------------XXX-----T-----T-------f
m-----EE-----B----E---E---|-----------E|--??-----------------E--------E-------T-----XXX-------------------E----E---XXX-------------------------------E--------X|----------------XXXX--E--|--E--|T----T-X
XXXXX-XXXXXXXXXXX-XXX--XXX|XXXXXXXXXXXX|XX--XXXXX-XXXX--XXXXXXXXXXXXXXXXXXXXXX|XXXXXXXXXXXXXXXXXXXXXXXXXXXXXXXXXXXXXXXXXXXXXXXXXXXXXXXXXXXXXXXXXXXXXXXXX--XXXXX|XXXXXXXXXXXXXXXXXXXXXXXXX|XXXXX||X--X|XX
