-----------------------------------------------------------------------------------------B-----------------------------------------------------------------------------------------B--------------------
----------------------------------------------------------------------------------------?-o----------------------?--------------------------------------------------------------M-B---------------------
-------o----------------------------M-----------------X------------------o--------------M-------------------X----------------------M--------------------------------------------------------------------
---------------------------------------------------X-----B-------------------------------o------------------------B--------o-----------------------------------o--------------------------X-------------
------B------------------?------B----------o--------------------------------B-------B-----------------------o------------------?--------------------o-B-------------------B-----------------------------
------------------------------------M--------------------------------------B-?----X---------o------------------------------------o-----------------------------------------?----------------------------
-------------------------------------------M-------------------------X---------------------------------------X------------------------------------------------------B-----------------------------------
-------------------------------????----------------------B----------------------XXXXXXXX-------X--?????o---------o-------------------X----------------------------------------------------------XXXX---v
------------------------------------X-------BM---XoXXXXo----------------------------------M--o---B-----o-------------------o--------------------------o---------------------o--------------------------f
--------------------------------------------------------------------??????--------------------------------------------------------------------------------------BBBBBBB--------------------------------f
----------------XXXXXXXX--------XXXXXXX-----------------------------------------------------------------------???---------------------------------------------------------------?????-------B----------f
----------------------------------------------------------------X----------------------------------------------------------------?????--------?????----------------------------------------------------f
-----------------------XXX-------------------------------------XX---------------------------------------XXXX--------------------------BX---------XBBBBBBB------X---------------------------------XXXXXXf
-----------------T--------T------------------------T---------TXXX---------------------------------T---T--T-----------------------------XX---------------------XX-----------------T-T----T--------------f
m---------E-E----|--------|----------E-------------|--T------|TTX---T--------------T------T------X|E--|--|--T------------E---EE------EEXXX-E-----------E-----XXX-----T-----------|T|----|E-----E-------X
XXXXXXXXXXX--XXXX|XX-XXXXX|XXXXXXXXXXXXXXXXXXXXXXXX|-X|XXXXXX|||XXXX|XXXXXXXXXXXXXX|XXXXXX|XXX--XX|XXX|X-|XX|XXXX-XXXXXXXXXXXXXXXXXXXXXXXXXXXXXX--XXXXXX--XXXXXXXXXXX|X-XXXX-XXXX|||-XXX|XXXXXXXXXXXXXXX
