---------------------------------------------------------o-----------------------------B----------------------------------------------o---------------o-------------------------------------------------
-------------------------------------------------------------o------o-----X------------------------------------------B----------o---------------------------B--?---------o----o-------------------------
-----------------------------------------------------Mo------------------------------------------?-?------------------------------------?-----------------------o-------o-B-----------------------------
----------o-------------------------------B----------------------o---M--------------B---o----------o--?----------o---B-----------------------------------------X----------------------?-----------------
-------o---------------B-----X------B---X-------------------?-------------------------------------------------B----------------------------------M------------------------------------------------------
-----------------o---------------o------X----?------------------?--------------------M----------------B---------------------------------------------?---------------------------------------------------
-------------B-------------------?-----------------------X-------M--------------o---------------------------------------------------?----M--o----------o--------------------B---------------?--------?--
------------------X--------------------X---------------B-----B------o---------------XXXXXXXX-?----------BBBBBB----------------------------B--BBBBBB------------X--------o-------------B----M-----------v
--------------------???-------------??--------X-----o---o-----X-????----------------------------------o----X-----??????o-------XXXX-------o-----------------------------------------BB-------B---------f
---------------------------------------????---------------------????-----------------------------------------------------------------------------------------------------------------------------------f
-------------------------------------------------------------------------------------------------------------------------------------------------------------------------------------------------------f
------------------------------???---------------------------XXX-------------------------------------------------------------------------------------------------BB-------------------------------------f
---------------------------------------------XX--------------------------------------------------------------------------XXX------------------------------------------BB-------------------------------f
----------------------------------------T-----------TT--------?????-------------X---------------T-X------------T---T------T---------X-------T-------------------------------T-------------------T------f
m-----T---T--------E-BTBBBBB---E--------|-E-E---E---||-TE----T----E---E-----T--XX---XXXXXTEX-T--|XX---E-------E|---|--E---|-----E--XX-T-E---|-T--------------------------BTB|----E-------E----T-|-T----X
XXXXXX|XXX|-XXXXXXXXXX|-XXXXXXXXXX--XXXX|XXXXXXX-XX-||X|-XXX-|X--X--XXXXXXXX|XXXXXXXXXXXX|--X|XX|XXX-XXXXXXX--X|---|XX--XX|XXX-XXXXXXX|X---X|-|XXXXX--XXXXXXXXXXXXXXXXX-XX|-|XXXXXXX--XXXXXX-X|X|-|XXXXX
