----------------XX----------B------------------------------------------------------------o-------B-------------------------------------------------------------------------------------o----------------
-------------------------------B-------------------------------?-----------B-B-----------------------------o--?---------------?-------X?--------------------------------M-------------------------X-----
---------------------------X----------------------------------B---M--------------o---o----------M-------------------?------------------X--------------------------o---------------------o----o----------
---------?--------------------------?-M-X-?-------------------------------------------------o---------------------------o------------------B--------------------------------------o---------------------
--------------------------------------------------------X------------B------------------------------------------------X-----------------X---------------------------------------------------------------
------------------------------?-------------------------------------------------------------------------------------------------------------?-----------------------o-----------------------------------
-------------------------M---o-------------------------------M----o----------------------------------B--------------o-?---------M-----------------------------------------------------------------------
---o------???-------M------------------------------------------------B-------------------------------X---B----------------?----------------------------------------------X---------------------o-------v
---------------------o-------------------------------------------------?o-----------------?------------------------------------------------------------------------------------------BBBBBBBB----------f
--------------------------------------------------------------------------------------------B-------------------------------------------------------XX-------------------------------------------------f
----------------------------------oXXXXXXX--------------------------------------------------------------------------------------------------------XXXXXX-----------------------------------------------f
------------------------------------XXXX------------------------------------------X------------------------------------------X-----------------------XX-----------------------------X------------------f
------------------X--------------------------------------------------------------XX-X--BBB-----------------------------------XX----------BBBBBBB----XXX---------X-X-----------XXXXXXXX-----------------f
-----------------XX--T----------------------XXX------------T------------------X-XXX-XX---------------------------------------XXX--X-T--------------XXXXBBB-T----XXTX-------X-T--XX-XXXX---T------T-----f
m-----------E---XXX--|-----------------------E---E---XXEXXE|------T--E-------XXXXXXTXXX-----E------EEXEXEX-TE-E------BBBEBBB-XXXTXXE|BBEB-TEE--E-EXXXXX-E-E|X--XXX|XXE-TE-EXX|--XTXXTTXT--|--E---|----XX
XXXXXXXXXXXXXXXXXXXX-|XXXXXX--XXX-----XX-XX-XXXXXX--XXX--XX|XXXXXX|XXX--XXXXXXXXXXX|XXXXXX--XXXXXXXXX--XXXX|X-XXX---X--XXXX-XXXX|XX-|XXXX-|--X--XXXXXXXXXX-|----XX|XXX-|--XXX|-XX|XX||X|XX|XX--XX|XXXXXX
