----------------------------------X---------oX----------------------------------------o-----------------------------------------------------------------------------------------------------------------
------------------------------------?-----------------------------------------------------------------?----------------------------B------B------------------------?---------?--------------------------
--------------------------------------------o-----------------------------------------------------MX----------------------------------------o-----------------------------------------------?-----------
----------?---------------------X------------------------M--------------------M------------------------------------------------------o--------------------------------------------------------M---------
-------------------M------------------------M---------B------------------------------o-------------------------------------------------------------------------------------------------------------o?---
---------------------B----------X----------------------------------------------------------------------o---M----------------------------------M---------------------------------------------------------
----X-------M----------------------------------B-o------------M-------------------------------------------------------------------------------------------------?---------------X------?----------------
-----------------------o---------?----------------------????--M-----BB-----???????-----o-X----------------XXXX---------------o--?????----------o------------------------------------------------X----o-v
--------XXXXX--o-??----M----------------?----B-------------------o---------------------------o------XXXXXX-?-------------------------o----------------B------------------------------------------------f
-------------------------------------------------------?????---------------------------------------------------------------------??????-----------------------------BBBBB???????----------------------Bf
------------??????--------------------------------------????--??BB??-------------------------------------------------------------------------XXXXX-------------------------------------------------????f
----------------------------XXXX----------------------------------------------XXXXXXX----------X---------------XXXXXXX-------------------------X-------------XXXXXX---------BB-------------------------f
----------------------------------------------------------???????-----------------------BBB---XX----BBB--????X?--------------------------------------------------X-------------------------------------f
----------------T------------------------------------------T-----------T--------TT-----------XXX----T--------XX--------------------T--------------BBBBBBB-----TT-XT----T------X------------------------f
m--------E----EE|T---T---T-E------E---T-E------EE-EE-------|-T-E-TTXX--|------E-||-TT--E-T-EXXXXE---|----ET-TXXX-------E-----------|-------------------E-T----||EX|X-T-|E----XX-----------X---T----E---X
XXXXX-XXXXXXXXXX||-XX|XXX|XXXX--XXXXXX|XXXXXXXXX-XX-XXXXXXX|X|XX-||XXXX|XXXXXXXX||X||XXXX|XXXXXXXXXX|XXXXX|X|XXXXXXXXXXXXXXXXXXXXXX|XXXXX-XXXXXXXXXXXXXXX|XXXX||XX|XX|X|XXXXXXXXXXXXXXXX-XXXXX|XXXXXXXXX
