-----------M--------------------------------------------------------------------------------------------------------------------------------------------------------------------------------------------
--------------------------------------------------------------------------------------------------------------------------------------------------------------------------------------------------------
---------M-----?----------------------------------------------------------------------------------------------------------------------------------------------------------------------------------------
--------B-------------------------------------------------------------------------------------------------------------------------------------------------------o---------------------------------------
--------------------------------------------------------------------------------------------------------------------------------------------------------------------------------------------------------
--------------------------------------------------------------------------------------------------------------------------------------------------------------------------------------------------------
---M----------------------------------------------------------------------------------------------------------------------------------------------------------------------------------------------------
-------------------------------------B-----------------------------------------------------------------------------------------------------------------------------------------------------------------v
----------------------------X-------------------------------------------------------------------------------------------------------------------------------------oBBBBB-------------------------------f
---------------------------------------------------------------------------------------------------------------------o---------XXXXXX------------------------------------------------------------------f
-----------------------------------------------------------------------------------------------------------------------------------------------------------------------------------T-------------------f
-------------------------------------------------------------------------------------------------------------------------------------------------------------T---------------------|-------------------f
---------------------------------??????----------------------------------------------------------------------------------------------------------------------|---T-----------------|XXXXXX-------------f
-----------------------------------------------------T------------------------------------------------------------------------------------------------X------|---|-----------------|-------------T-----f
m------------EE--------------------------------------|---------------------------------------------------E--------------X---------------------------EXX------|---|-----------------|-------------|-----X
XXXXXXXXXXXXX-XXXXXXXXXXXX--XXXXXXXXX---XXXX---XXXXXX|XXXXXXXXXXXXXXXXXXXXXXXXXXXXXXXXXXXXXXXXXXXXXXXXXXXXXXXXXXXXXXXXXXXXX---XXXXXXXXXXX---XXXXXXXXXXXXXXXXX|XXX|XXXXXXXXXXXXXXXXX|XXXXX--XXXXXX|----XX
