-----------------------------------------------------X---------------------------------------------------------------------------------------------------------o------------------------X---------------
---------------------------------------------------------------------------------------------------------------------------------M------------------o-------?---------B---------------------B-----------
------------X------------------------------?-----------------------------------------------------?o---------------------------------M----M------M----------------------------------------o--------------
------------------------B--------------------------------------------------------------------------------------M-----------------------------------X--------------------------------------M----o-----o--
----------------o---M--------------------------------------------B--------------------------------------Mo----X---------------------------------------------------------------------------?--X----------
------------------------------------------o-------------X-X--------?-----------------------?--------o-----------------------------------------------------o---------------------------------M---M-------
-------------X------------------------------------------------------------------------------------B--------------B-------------------------------------?---------X-o----------------------------?-------
----------------------------------o----BBBBBBBo-----------BBB---------------------------X---M--------------------M--------------------------------------------------oXB-----------------------------XXXv
----------------BBBBBBB----------------------X-o-----------------XXXXXXX--------------------M--------------------------?----------------M-----------------------------------XXXX------------------?----f
-------------------------------------------------------------------------------------------------------------------------------------------------------------------------------------------------------f
-----------------------------------------------------------------------------------???--------BBBBBB------------------------------------------------------------BBBBB----------------------------------f
-------------------------------XXXXXX---------------------??--------------------------BBBBBB---------------------------------------------------------------------------------------------------------??f
------------------------------------------------------------------------------------------------------------------------------------------------------------------------X--X---------------------------f
-------------??--------------X-------------------------T---------------------------------------------XXXXXXX-----------------------T------------TT---------------------XX--XX--------X-----------T-----f
m------T-------T----T----EE--XX--T--E------E----XXXXE--|------------------------E-B----E---------E---E-----E---------TE------------|------------||T--T----------------XTX--XXXE----TXX------E----|ET---X
XXXXXXX|XXXXXXX|XX--|-XXXXXXXXXXX|--XXXXXXXXXXXXXXXXXXX|-XXXXXXXXXXXXXXXXXXXXXXX-XX--XXXXXXXXXXXX--X-XXXXXXXXXXXXXXXX|XXXXXXXXXXXXX|--XXXXXXXX--|||XX|XXXXXXXXXXXXXXXXX|X-XXXXXXXXX|XXXXXXXX--X--|X|X--X
