----------------------------------------------------------------------------------------------------------------------------------------------------------------------------------------------------B---
------------------------------------------------------B--------------------------------------------------------o----------------------------------------------------------M------------------B----------
--------------------------------------------------------------?-----------------------------------------------------------------------------------------------------------------------------------------
--------M-------?------------------------------------------------------B----------------------------o--------------------------------------------------o------------------------------------------------
-----------------------------------------------------------------------X------------------------------------------------------------------?----------------------------------------------------o--------
------------------------------------------------------------------------------------------------------------oo-------o-----------------------------------------------------X----------------------------
-------------------------X---------------o-B------------------------------------------M---------------------------------------X-------------------------------------------------------------------------
--------------------------------------------------------?-----------------------------------------------------------------------------X---------?????-----------------------------------o-----M--------v
----------------M--------------------------------------------------------------------------------------------------------------?---------------------------------?-------------------------------------f
---------???????----------------------------------????????---------------------------------------------------------------------------------------------------------------------------------------------f
------????-----------------------------------------------------------------------------------------------?????--------------------------------------------------------------------------???????--------f
-------------------------------------------------------------------------------------------------------------------------------------------------------------------------------------------------???---f
-------------------------------------------------------------???????---------------------------------------------XXX-----------------????--------------------------------------------------------------f
-----------???????-------------T----------T---------X------------------------------------------------------------------------T-----X-----------------------------------------------X--T----------------f
m-----T-E-EE-E-------------E---|---------T|??------XX--------E------------------E--B---------T--------------------------E----|-----XX-------??--------T-E-----T-------E------------XX-|--T-----------T-X
XXXXXX|XXXXXXXXXXXXXXXXXXXXXXXX|XXXXXXXXX||XXXXXXXXXXXXXXXXXXXXXXXXXXXXXXXXXXXX--XXXXXXXXXXXX|XXXXXXX--XXXXXXXXXXXXXXXXXXXXXX|XXXXXXXXXXXXXXXX-XXXXXXX|XXX--XX|XXXXXXXXXXXXXXXXX-XXXXX|XX|X--XXXXXXXX|XX
