----------------------------X----------------------------------------------------------------------------------------------------------o--B--------------------------?----------------------------------
-----------------------------------------------------------------------------o----------------------------------------------------o-------------------------------------------------o---------o---------
---------------------------------------M---------------------------?------------------------------o------------------------------------M-------------------B----------M------------------o--------------
-------------------------------------?----------------------------------------------------------o---------------B---------------------------------------------------------------------------------------
-------------------------------------------------------------------------------------------------------------------------------------------------------X----B-----------------------------o---o---------
---------------------------------------M---------------------------M--XXX------------------------------------------------B------------------------------------------------------------------------------
---------------------------------------o-----------------------------------------B----------------------------------------------------------------------------------------------------------------------
---------------------------------------------B-------X----????--------------o--------------------------------------------------------o----????????--X--------------------------------------------------v
-----------------------------------------------------??????--------------------------X----------------------------------------------------------------XXXXX-----------M----------XXXo???????-----------f
---------------------------------o-------------------------------------T----------o--------T------B-----------------------------------------------------------B-------------------------o------------M-f
-----BBBBBBBB------------------------------------------------------B-T-|-------o-----------|--------------------------------------------------------------------------------------------------------o--f
------------------------------------------------T-----------------T--|-|-------------------|----------??------------------------X---X-----------------------T-------BBBBBBBB----------------------T----f
-------------------------------------T----------|-----------------|B-|-|-----------X-------|-?-------------T-------------------XX--XXT----------------------|-------------------------------------|----f
------------BBBBBB-------------------|----------|-----------------|--|-|-----------XX------|---------------|------------------XXX-XXX|----------------------|-------------------------------------|----f
m------------------------------------|----------|------E---------E|??|-|----E------XXX-----|---------------|-----------------XXXXXXXX|-E----E-----EE----???-|--------------------EE-E-------------|--X-X
XXXX--XXXXXXXXXXXXXXXXXXXXXXXXXXXXXXX|XXXXXXX-XX|XXXXXXXXX---XXXXX|XX|X|XXXXXXXXX-XXXXXX-XX|-XXXXX---XX---X|XXXXXXXXXXXXXXXXXXXXXXXXX|XXXXXXXXXXXXXXXXXXXXXX|XXXXXXXXXXXXXXXXXXX---XXXXX--X---XXXX|XXXXX
