---------------------------------?X------------------------------------------------------------------------------X---------------------------------------------------------M---------------------X------
-------------------------------------------------------------B------------------------------------------------------------------------------------------------------------------------------------------
---------o---------------------------------------------------------------------------------------o------------------------------------------------------------------------------------------------------
-----------------------------------------------------------------------------------B---------------------o----------------------------------------------------------------------------------------------
---------------------------------------------------------------X-------------------------o--------------------------------------------------------------------------------------------------------------
--------------------------------------------------------------------------------------------------------------o------------------------------------------------------o----------------------------------
---------------------o-------------------------------------------------------------X-------?--------------X-----X--------------------------------------------------o----------------------o-------------
----------------------------------------------------------------------------------------------------B----------------M---------------------------------------------------------------------------------v
-----------------------------------------------?---------------------------B-----------------------------------XXXXXXXX------------------------?--------------------------------M----------------------f
-------------------------------------------------------------------------------------------------------------------------------------------------------------------------------------------------------f
---------------------------------------------------------------------------------------------X--------------------------------T------------------------------------------------------o-----------------f
--------------------------------X--------------T--------------------------------------------XX--------------------------------|------------------------------------------------------------------------f
--------------------------T-----XX--------T----|-------------------------------------------XXX-----------------------T--------|---------------------------T--------------------X-----------------------f
--------------------------|-----XXX-------|----|------------------------------------------XXXX------T----------------|--------|---------------------------|-------------T--------------------------X---f
m-------------------------|-----XXXX-?????|----|-----------------E-----------------------XXXXX------|-------E--------|-X------|---------------------------|-----E-------|---E---------------------XX---X
XXXXXXXXXXXXXXXXXXXXXXXXXX|XXXXXXXXXXXXXXX|XXXX|XXXXXXXXXXXXXXXXXXXXXXXXX---XXXXXXXXXXXXXXXXXXXXXXXX|XXXXXXXXXXXXXBXX|XXXXXXXX|XXXXXXXXXX-----XXX--XXXXX--|XXXXXXXXXXXXX|XXXXXXX????????XXXXXXXXXXXXXX-X
