EB-E---XE--o--M-M-B------E-M---M----M-----M-XE-o-X--------E---B---M-----o-o-?---X--ME----o-E---M---Xo-----EE-M-EBo-M---E---------BE-----E-o-MXE----oM----BBB-----EE-BE---------o-----BE---EE--?-?E-X---X
X----B------EME-BBB-X?-o---B---M--E--o----B--B-----?--?----o-B---------------BMo---ME------E--B-Mo-------M--E---?------B-M-B---E--M--o------------E---M-M---B-------------o--o-oX-?-o-BoE?EME--E-o--oX-E
M--------M----o--XM--BM-E------E--?---o----o-o---E--------M--------o----BB----o------??-X-M-o---X---?-?XB-----?-M---o?--------?----EoEoB--B----o--B---?oE-o---EEE-E---X-----B----------o----B-----E----E
M----E--?-o--X-M-----------?E-------?X-------ME----M--E-B---o-ME---------X----BME---X--E-?X-E-XBo---M----XXB---o-----o---X---------EMX-o-E---------X-----B-B---XM?--------X--B-oBo----?--B------E----X--
M-----X----------o--BB?E-B?E--ooX---o-X---?-X-----o--M---?----B---?M--M--?-?--B--M--------M----M---BM----?-oX-M-------?---X--o-EE--oo-M---------?B-?---o----oE?---Xo----EB--X-B---?-XM-E-----?---X---?-o
|-M-E--??----B-?--------B-?XM--?----M-M---XBEEo?---o---X?M--X?---EE-XB-X------Bo-?X---?X-----XMMM-E----Mo-BM--X-M?-EM-?------XE---BM---B-ME----BE----BBo--ME-----XEoB--E------M------oX-ooM--B-Bo-X-?--E
E-----o----------E----E-o----X-?---M---?-?-----oEB---E--M?-?-E-?-------X----BB---E------E-------M----E---?-B---o----E-BE------B-?o---X-o---ME-X?----?-E-BX------?X--?--Mo---B-E---M-?-M--E--E-------?M-X
o-----o---MX--o-?oB----?--X--X-B----?-E---BB----B--o-X--M--X--EE--o?X---BX-?------?-MX--X--B--o-E-M-----E------oM--oXM-----o------?--E-------Eo--B--B----------MB----?---E--E--------B---X--Xo-?---X-XXv
M?--M-----?---E----ME---o----E--B-------------o--?---E---E?-M-M------MM--BE---o?---?X-X--------B-------------o?-------o-----M--X-X-X---?E-Mo--X-?ooM?-----EBM-------MX-B----B-EE--oM---oXX---o----o-X?-X
B--MX-----?---------E--------?--B-EX??--XXME------BE--------?BM-?--------M--?-?EE---M--------B-B---MM?----o--M---M---?-M---o----?B----------MX-E-o---E--X------------------E--o-XE---EEo-o--?------?E--?
BoMo-------X-o-------?-EM-X-----M-------?E-----?oo--o----MX--B?---------M-MB--E---?-?-------o-----E----BE-----o-B---o-o--M-o--?----o-M--E-E--B------B-------------o-X-XX--M-----oo--E------B-o---?B-o---
?--??-?-?--E-B-?-X---B-------?B--??----E?EEX---------M-?-----X------o--o--E------B---MB---M--BB--B--E-?o------E?---M----------o---M---B?-B-MX--M-o---B-oBMo--M-X-B-o-----?E-oX------X-B----BX-?-EM?-----
MoE---oX---X-----M----------X-------M-----oB------B-X-o-EB----X--M-----E-X--------------oX--B-M-?B-E----BMM-?---M---o----------EM--E---E-------M-------------XX-B?M-X-o--E-------B---------X----E-B-B--|
----M-Bo-B-oBE-M?-------------E-MM?----X------o----o-B-B-Xo--X---E---XE----E---o|-----o--?-----X--BM-------M-M-M---M-----B----MX------?--XM-------EE--------?--o--B-----------o-M-X--X--M----o-X?B-----M
mXo-M--E--X-To---|X-X------?oXM--X--XT-E----oo--X-X-|-T|T--M-|---E--Eo-T-o-B-ToET---o?--B-E--?---B-?oE-T--E-MM-|EEXo--------T-E?-EM----X--oM-|-o-|o|-?-Eo--M-X|?-o-----M-MB--MX-B-T-----?-?---o-|E-XME-|
XXXXXXXXXXXXXXXXXXXXXXXXXXXXXXXXXXXXXXXXXXXXXXXXXXXXXXXXXXXXXXXXXXXXXXXXXXXXXXXXXXXXXXXXXXXXXXXXXXXXXXXXXXXXXXXXXXXXXXXXXXXXXXXXXXXXXXXXXXXXXXXXXXXXXXXXXXXXXXXXXXXXXXXXXXXXXXXXXXXXXXXXXXXXXXXXXXXXXXXX
